111111111
1P1C1C1E1
101000001
1C1111101
1000C1101
111101001
100001011
101111C11
100000011
111111111




