11111 11111
1PEC1 10001
11111 11111