111101
1P0001
111C1
1C1E1
11111