11111111111
1PdfghjlEC1
11111111C11
11111111C11
11111111111