11111
1PCE1
11111

11111
10001
11111