111101
1P0001
101C1
1C1E1
11111